"""
###############
#             #
#             #
#             #
"""
"""
###############
# # # # # # # #
# #         # #
#             #
"""