"""
##########
#        #
#        #
#        #
"""
"""
# # # # ##
# # # # ##
# #   # ##
#       ##
"""